# Typos
# Correction of common typos.
amiboo,amiiboo,amibo => amiibo
assasin,asasin,asassin,assasine => assassin
assasins,asasins,asassins => assassins
athem => anthem
atilla,attilla,atila => attila
battel => battle
battelfront => battlefront
battelfield => battlefield
batlefield => battlefield
battlefild => battlefield
blueray,bluray => blu ray
controler => controller
desteny => destiny
detroid => detroit
diabolo => diablo
dishonered => dishonored
divison,devision => division
diyng => dying
dreanor => draenor
drivr => driver
efect => effect
evovle => evolve
falout,fall out => fallout
fortnight => fortnite
gihbli,gibli => ghibli
gild => guild
gohst => ghost
grand turismo => gran turismo
grand tourismo => gran turismo
helo => halo
jurasic,jurrasic => jurassic
kindom => kingdom
kingdome => kingdom
moto gp => motogp
nitendo => nintendo
nintendo nx => nintendo switch
no men sky,no mens sky => no mans sky
odissey => odyssey
odysee => odyssey
pay day => payday
pice => piece
rachet => ratchet
read dead => red dead
redemtion => redemption
redeption => redemption
spangebob => spongebob
spidermann => spider man
tourismo => turismo
triton => tritton
turtels => turtles
unchartet,unchardet => uncharted
until down => until dawn
wicher,whitcher,withcer => witcher

# Compounds
#Â Customers often search for compound words instead of individual words. Sometimes that leads to no matches found. That's why we split these compound words.
assassinscreed,assasincreed,asasincreed,asassincreed,assasinscreed,asasinscreed,asassinscreed => assassins creed
darksouls => dark souls
deadrising => dead rising
deadspace => dead space
dragonquest => dragon quest
driveclub => drive club
elfenlied => elfen lied
eurotruck => euro truck
fate extella => fateextella
flightsimulator => flight simulator
flugsimulator => flug simulator
gearclub => gear club
granturismo => gran turismo
guildwars => guild wars
ironman => iron man
kingdomhearts => kingdom hearts
landwirtschaftsimulator => landwirtschafts simulator
madmax => mad max
mariokart => mario kart
monsterboy => monster boy
monsterhunter => monster hunter
neogeo => neo geo
onepiece => one piece
rockband => rock band
saintsrow => saints row
southpark => south park
spiderman => spider man
starfox => star fox
starwars => star wars
supermario => super mario
supernintendo => super nintendo
super man => superman
tombraider,tomb rider => tomb raider
topspin => top spin
watchdogs,watchdog => watch dogs
wonderwoman => wonder woman